W,W,W,W,W,W,W,W,W,W,W,W,W,W,W,W
W,,T,,,G,,,,,,,,G,G,W
W,G,TG,T,,,,G,,TG,,,G,G,G,W
W,,TG,TG,,T,,,T,TG,TG,,,,,W
W,,TG,TG,T,T,T,,,TG,T,T,,,,W
W,,,T,,G,,,,T,T,TG,TG,G,,W
W,,,T,T,,T,,G,,,G,,,G,W
W,,,G,,,,G,,,,,,G,G,W
W,T,,,,TG,T,G,G,,TG,TG,T,,,W
W,TG,TG,,T,TG,TG,,,T,,TG,,T,,W
W,TG,TG,TG,G,T,,,TG,TG,T,T,T,G,T,W
W,T,T,G,,,,G,T,TG,TG,,T,TG,T,W
W,T,,,TG,T,,,T,T,G,T,TG,G,T,W
W,,G,TG,TG,TG,T,G,G,TG,T,T,,TG,,W
W,,,,TG,G,,,,,T,T,T,G,,W
W,W,W,W,W,W,W,W,W,W,W,W,W,W,W,W